1111111
10E0001
1P000C1
1111111