1111111111111111111
1P000000000000000C1
1001000110010011001
1010101000101010101
1011101000111011001
1010101000101010101
1010100110101011001
1C000000000000000E1
1111111111111111111